GraphToWeighted.cs	重みなしグラフを重み付きグラフに変換
オイラー路.cs	オイラー路
帰りもあるオイラーツアー.cs	帰りもあるオイラーツアー
強連結成分分解.cs	強連結成分分解
最小共通祖先.cs	最小共通祖先
最小共通祖先.WithData.cs	データ付き最小共通祖先
最小全域森Kruskal.cs	最小全域森(Kruskal)
最小全域木Bfs.cs	最小全域木(幅優先探索)
最小全域木Prim.cs	最小全域木(Prim)
最小全域木のResult.cs	最小全域木の結果
最小有向全域木.cs	最小有向全域木
最大流.cs	最大流
最短経路01Bfs.cs	最短経路(01-BFS)
最短経路BellmanFord.cs	最短経路(BellmanFord)
最短経路Bfs.cs	最短経路(幅優先探索)
最短経路Dijkstra.cs	最短経路(Dijkstra)
最短経路Dijkstra復元付き.cs	経路復元付き最短経路(Dijkstra)
最短経路WarshallFloyd.cs	最短経路(WarshallFloyd)
閉路検出Dfs.cs	閉路検出
閉路削除Dfs.cs	閉路削除
木のノードの距離.cs	木のノードの距離
木の子孫数.cs	木の子孫数
木の探索.cs	木の探索
